2222222222222222222222
22222222222..........2
22222222222..........2
22222222222..........2
2222222222222222222222
2222222222222222222222
2222222222222222222222
22.......2222222222222
2222222222222222222222
2222222222222222222222
222222.....22222222222
2222222222222222222222
2222222222222222222222
2222222222222222222222
2222222222222222......
2222..2222222222222222
2222222222222222222222
2222222222222222222222
2222222222222222222222
2222222......222222222
2222222......222222222
2222222......222222222
2222222......222222222
2222222222222222222222
..22222222222222222222
..22222222222222.22222
2222222222222222222222
22222...22222222222222
2222222222222222222222
2222222222222222222222
2222222222222222222222
2222222222222222222222
22222222222222.....222
22222222222222.....222
22222222222222.....222
2222222222222222222222